GGGGGGMGMGGGGGGGMGGGGGGGGBGGGGGGGGGGGGGGGGGGGGGGGGGGGGMGGGGGGGGGGGGGGGGGGGGBGGGGGGGGGGGGGGGGGGGGGGGG
GGGGGGGGGGGMGGGGGGGGGGGGGBGGMGGGGGGGGGGGGGGMGGGGGGGGGGGGGGGGGGGGGGGGGGGGGGGBGGGGGGGGMGGGGGMGGGGGMGGG
MGGGGGGGGGGGGGGGGGGGGMMGGBGGGGGGGGGGGGGGGGGGGGGGGGGGMGGGGGGGGGMGGGGGGGGGGGGBGGGGGGGGGGGGGGGGGGGMGGGG
GGGGGGMGGGGGGGGGGMMGGGGGGBGGGGGGGGGMGGGGGGGGMGGGGGGGGGGGGGGGGMGMGGGGGGGGGGGBGGGGGGGGGGGGGGGGGGGGGGGG
GGGGGGGMGGGGGGGGGGGGGGGGGBGGGGGGGGGGGGGGGGGGGGGGGGGGGGGGGGGGGGGGGGGGGGGGGGGBGGGGGGGGGGGGGGGGGMGGGGGG
GGGGGGGGGGGGGGGGGGGGMGGGGBGGGGGGGGGGGGGGGGGGGGGGGGGGGGGGGGGGGGGGGGGGGGGGGGGBGGGGMGGGGGGGGGGGGGGGGGGG
GGGGGGGGGGGGGGGGGMGGGGGGGBGGGGGMGGGGGGGGGGGGGGGGGGGGGMGGGGGMGGGGGGGGGGGGGGGBGGGGGGGGGGGGMGGGGGGGGGGG
GGGGGGGGGGGGGGGGGGGGGGGMGBGGGGGGGGMGGGMGGGGGGGGGGGGGGGGGGGGGGGGGGGGGGMGGGGMBGGGGGGGGGGGGGGGGGGGGGGGG
GGMGGGGGGGGGGGGGGGGGGGGGGBGGGGGGGGGGGGGGGGGGGGGMGGGGGGGGGGGGGGGGGGGGGGGGGGGBGGGGGGMGGGGGGGGGGGGGGGGG
GGGGGGGGGGGGGGGGGGMGGGGGGBGGGGGGGGGGGGGGGGGGGGGGGGGGGGGGGGGGGGGMGGGGGGGGGGGBGGGGGGGGGGGGGGGMGGGGGGGG
GGGGGMGGGGGGGGGGGGGMGGGGGBGGGGGMGGGGGGGGGMGGGMGGGGGGGGGGGGGGGGGGGGGGGGGGGGGBGGGGGMGGGGMGGGGGGGGGGGGG
GGGGGGGGGGGGGGGGGGGGMGGGGBGGGGGGGGGMGGGGGGGGGGGGGGGGGGGGGGGGGGGGGGGGGGGGGGGBGGGGGGGGGGGGGGGGGGGGGGGG
GGGGGGGGGGGGGGGGGGGGGGGGGBGMGGGGGGGGGGGGGGGGGGGGMGGGGGGGGGGGGGGGGGGGGGGGGGGBGGGGGGGGGGMGGGGGGGGGGGGG
GGGGMGGGGGGGGGGMGGGGGGGGGBGGGGGGGGGMGMGGGGGGGGGGGGGGGGGGGGGGGGGGGGGGGGGGGMGBGGGGGGGGGGGGGGGGGGMGGGMG
GGGGGGGGGGGGGGGGGGGGGGMGGBGMMGGGGGGGGGGGGGMGGGGGGGGGGGGGMGGGGGGGGGMGGGGGGGMBGGGGGGGGGGGGGGGGGGGGGGGG
GGGGGGGMGGGGGGGGGGGGGGGGGBGGGGGMGGGGGGGGGGMGGGGGGGGGGGGMGGGGMGGMGGGGGGGGGGGBMGGGGGGGGGGGGGGGGGGGGGGG
GGGMGGGGGGGGGGGGGGGGGGGGGBGGGGGGGGGGGGGGGGGMGGGGGGGGGGGGGGGGGGGGGGGGGGGMGGGBGGGGGGGGGGGGGGGGGGGGGGGG
GGGGGGGGMGGGGGGGGGGGGGGGGBGGGGGGGGGGGGGGGGGGGGGGGGGGGGGGGGGGGGGGGMGGGGGGGGGBGGGGGGGGGGGGGGGGGGGGGGGG
GGGGGGGGGGGGGGGGGGGGGGGGGBGGGGMGGGGGGGGGGGGGGGGGGGGGGGGGGGGGGGGGGMGMGGGGGGGBGGGGGGGGGGGGMGGGGGGGGGGG
GGGGGGGGGGGGGGGGGGGGGGGGGBMGGGGGGGGGGGGGGGGGGGGGGGGGGGGGGMGGGGGGGMGGGGGMGGGBGGGGGGGGGGGGGGGGGGGGGGGG
GGGGGGGGGGGGGGGMGGGGGGGGGBGGGGGGGGGGGGGGGGGGGGGGGGGGMGGGGGGGGGGGGGGGGGGGGGGBGGGGMGGGMGGGGGGGGGGGGGGG
GGGGGGGGGGGGGGGGGGGGGGGGGBGGGGGGGGGGGGGGGGGGGGGGGGGGMGGGGGGGGGGGGGGGGGGGGGGBGGGGGGGGGGGGGGGGGGGGGGGG
GGGGGGGGGGMGGGGGGGGGGGGGGBGGGGGGGGGGGGGGGGGGGGGGGGMGGGGGGGGGGGGGGGGGGGGGGGGBGGGGGGGGGGGGGGGGGMGGGGGG
GGGGGGGGGGGGGGGGGGGGGGGGGBGGGGGGGGMGGGGGGGGGGGGGGGGGGGGGMGGGGGGMGMGGGGGGGGGBGGGGGGMGGGGGGGGGGGGGGGGG
GGGGGGGGGGGGGGGMGGGGGGGGGBGGGGGGGGGGGGGGGGGGGGGGGGGGGGGGGGGGGGMGGGGGGGGGGGMBGGGGGGGMGGGGGGGGGGGGGGGG
BBBBBBBBBBBBBBBBBBBBBBBBBBBBBBBBBBBBBBBBBBBBBBBBBBBBBBBBBBBBBBBBBBBBBBBBBBBBBBBBBBBBBBBBBBBBBBBBBBBB
GGGGGGGGGGGGGGGGGGGGGGGGGBGGGGGGGGGGGGMGGGGGGGGGGGGGGGGGGGGGGGGGGGGGGGGGGGGBGGGGGGGGMGGGGGGGGGGGGGGM
GGGGGMGGGGGGGMGGGGGGGGGGGBGGGGGGGGGMGGGGGMGGGGGGGMGGGGGGGGGGGGGGGGGGGGGGGGGBGGGGGGGGGGGGGGGGGGGGGGGG
GGGGGGGMGGGGGGGGGGGGGGGGGBGGGGGGGGGGGGGGGGGGGGGGGGGGGGGGGGGGGGGGGMGGGGGGGMGBGGGGGGGGGGGGGGGGMGGGGGGG
GGGGGGGGGGGGGGGGGGGGGGGGMBGGGGGGGGGGGGGGGGGGGGGGGGGGMGGGGGGGGGGGGGGGGGGGGGGBGGGGGGGGGGGGGGGMGGGGGGGG
GGGGGGGGGGGGGMGGGGGGGGGGGBGGGGGGGGGGMGGGGGGGGGGGGGGGGGGGGGGGMGGGMGGGGGGMGGGBGGGGGGGMGGGGMGGGGGGGGGGG
GGGMGGGGGGGGGGGGGGGGGGGGGBGGGGGGGGGGGGGGGGGGMGGGGGGGGGGGGGGGGGGGGGGGMGGGGGMBGGGGGGGGGGGGGGGGGGGGGGGG
GGGGMGGGGGGGGGGGGGGGGGGGGBGGGGGGGGGGGGGGGGGGGGGGGGGGGGGGGGGGGGGGGGGGGGGGGGGBGMGGGGMGGGGGGGGGGGGGGGGG
GGGGGGGGGGGGGGGGGGGGGGGGGBGGGMGGGGGGGGGGGGGGGGGGGGGGGGGGGGGGGGGGGMGGGGMGGGGBGMGGGGGGGGGGGGGGGGGGGGGM
GGGGGGGGGGGGMGGGGGGGGGGGGBGGMGGGGGGGGGGGGGGGGGGGGGGGGGGGGGGGGMGGGGGGGGGGGGGBGGGGGGGGGGGGGGGMGGGGGGGG
GGGGGGGGGGGGGGGGGGGGGGGGGBGGGGGGGGGGGGGGGGGGGGMGGMGGGGGGGGGGGGGGGGGGGGGGGGGBGGGMGGGMGGGGGGGGGGGGGGGG
GGGGGGGGGGGGGGGGMGGGGGGGGBGGGGGGGGGGGGGGGGGGGGGGGMGGGGGGGGGGGGGGGGGGGGGGGGGBGGGGGGGGGMGGGGGGGGGGGGGG
GGGGGGGGGGGGGGGGGGGMGGGGGBGGGGMGGGGGGGGMGGGGGGGGGGGGGGGGGGGMGGGGGGGGGGGGGGGBGGGGGGGGGGGGGGGGGGGGGGGG
GGGGGGGGGGGGMGGGGGGGGGGGGBGGGGGGGGGGGGGGGGGGGGGGGMGGGGGGGGGGGGMGGGGMGGGGGGGBGGGGGGGGGGGGGGGGGGGGGMGG
GGGGGGGGGGGGGGGGGGGGGGGGMBGGGGGGGGGGGGGGGGGGGGGGGGGGGGGGGGGGGGGGGGGGGGMGGGGBGGGGGGGGGGGGGGGGGGGGGGGG
GGGGGGMGGGGGGGGGGGGGGGGGGBGGGGGGGGGGGGGGGGMMGGGGGGGGMGGGGMGGGGGGGGGGGMGGGGGBGMGGMGMGGGGGGGGGGGGGGGGG
GGGMGGGGGGGGGGGGGGGGGGMGGBGGMGGGGGGGGGGGGGGGGGGGGGGGMGGGGMGGGGGGGGGGGGGGGGGBGGGGMGGGGGGGGGGGGGGGGGGG
GGGGGGGGGGMGGGGGGGGGMGGGGBGGGGGGGGGGGGGGGGGGGGGGGMGGGGGGGGGGGMGGMGGGGGGGGMGBGGGGGGGGGGGGGGGGGGGGGGGG
GMGGGGGGGGGGGMGGGGGGGGGGGBGGGGGGGGGGGGGGGGGGGGGGGGGMGMGGGGGGGGGGGGGGGGGGMGMBGGGGGGGGGGGGGGGGGGGGGGGG
GGGGGGGGGMGGGGGGGGGGGGGGMBGGGGGMGGGGGGGGGGGGGGGMGGGGGGGGGGGGGGGGGMGGGGGGGGGBGGGGGGGGGGGGGGGGGGGGGGGG
GGGGGGGGGGGGGGGGGGGGGGGGGBMGGGGGGGGGGGGGGGGMGMGGGGGGMGGGGGGGGGGGGGGMGGGGGGGBGGGGGGGGMGGGGGGGGGGGGGGG
GGGGGGGGGGMGGGGGGGMGGGGGGBGGGGGGGGGGGGGGGMGGGGGGGGGGGGMGGGGGGGGGGGGGGGGGGGGBGGMGGGGMGGMGGGGGGGGGGGGG
GGGGMGGGGGGGGGGGGGGGGGGGGBGGGGGGGGGMGGGGMGGGGGGGGGGGGGMGMGGGGGGGGGGGGGMGMGGBGGGGGGGGGGGGGGGGGGGGGGGG
GGGGGGGGGMGGGGGGGGGGGGGGGBGGGGGGMGGGGGGGGGGGGGGGGGGGGGGGGGGGGGGGGGGGGGGGGGGBGGGGGGGMGGGGGGMGGGGGGGGG
GGGMGGGGGMGGGGMGGGGGGGGGGBGGMGGGGGGMGGGGGGGGGGGGGGGGGGGGGGGGGGGGGGGGGGGGGGGBGGGGGGGGGGGGGGMGGGGGGGGG
GGGGGGGGGGGGMGGGMGGGGGGGGBMGGGGGGGGGGGGGGGGGGGGGGGGGGGGGGGGGGGGMGMMGMGGGGGGBGGGGGGGGMGGGGGGGGGGGGGGG
GGGGGGGGGGGGGGGGGGGGGGGGGBMGGGGGGGGMMGGGGGGGGGGGGGGGGGGGGGGGGGGGGGGGGGGGGGGBGGGGGGGGGGGGGGGGGGGMGGGG
GGGGGGGGGGGGGGGGGGGGGGGGGBGGGGGGGGGGGGGGGGGGGGGGGGGGGGGGGGGGGGGGGMGGGGGGGGGBGGGGGGGMGMGGGGGGGGGGGGGG
GGGGGGGGGGGGGGGGGGGGGGGGGBGMGGGGGGGGGGGGGGGGGGGGGGGMGGGGGGGGGGGMGGGGGGGGMMMBGGGGGGGGGGGGGGGGGGGGGGGG
GGGGGGGGGGGGGGGGGGGGGGGGGBGGGGGGGGGMGGGGGGGGGGGMGGGGGGGGGGGGGGGGGGGGGGGGGGMBGGGGGGGGGGGGGMGGGGGGGGGM
GGGGGGGGGGGGMGGGGGGGGGGGGBGGGGGGGGGGGMGGGGGGGGGGGGGGGGMGGGGGGGGGGGGGGGGGGGGBGGGGMGGGGGGGGGGGGGGGMGGG
GGGGGGGGGGGGGGGGGGGGGGGGGBGGGGGGGMGMGGGGGGGGGGGGGMGGGGGMGGGGGGGGGGMGGGGMGGGBGGGGGGGGMGGGGGGGGGMGGGGG
GGGMGGGGGGGGGGMGGGGGMGGGGBGGGMGGGGGGGGGGGGGGGGGGGGGGGGGGGGGGGGGGGGGGGGGGGGGBGGGGGMGGGGGGGGGGGGGGGGMG
GGGGGGMGGGGGGGGGGGGGGGGGGBGGGGMGGGGGGMGGGGGGGMGGGGGGGGGGGMGGGGGGGGGGGGGGGGMBGGGGGGGMGGGGGGGGGGGGGGGG
GGGGGGGGGGGGGGGGGGGGGGGGGBGGGGGGGGGGGGGGGGGGGGGGGMGGGGGGGGGGGGGGGGGGGGGGGGGBGGGGGGGGGGGGGGGGGGGGGGGG
GGGGGGGGGGGGGGGGGGGGGGGGGBGMGGGGGGGGGGGGGGGGGGGGGGGGGGMGGGGGGGGGGGMGGGGGGGGBGGGGGGGGGGGGGGGGGMGGGGGG
GGGGGGGGGGGGGGGGGGGGGGGGGBGGGGGGMGGGGGGGGGMGGGGGGGGGGGGGGGGGGGGGGGGGGGMGGGGBGGGGGGGGGGGGGGGGGGGGGGGM
GGMGGGGGGGGGGGGGGGGGGGGGGBGGGGGGGGGGGGGGGGGGGGGGMGGGGGGGGGGGGGGGGGGGGGGGGGGBGGGGGMGGGMGGGGGGGGGGGGGG
GGGGGGGGGGGGGGGGGMGGGGGGGBGGGGGGGGGGGGMMGGGGGMGGGGGGGGGGGMGGGGGGGGGGGMGGGMGBGGGGGGGGMGGGMGGGGGGGGGGG
GGGGGGGGGGGGGGGGGGMGGGGGGBGGGGGGGGGGGGGGGGGGGGGGGGGGGGGGGGGGGGGGGMGGGGGGGGGBGGGGGGGGGGGGGGGGGGGGGGMG
GGGGGGGGGGGGGGGMGGGMGGGGGBGGGGGGGGGGGGMGGGGGGGMGGGGGGGGGGMGGGGGGGGGGGGGGGGGBGGGGGGGMGGGGGGGGGGGGGGGG
GGGGGGGGGGGGMGGGMGGGGGGGGBGGGGGGGGGGMGMGGGGGGGGGMGGGGMGGGGGMGGGGGGGGGGGGGGGBMGGGGGGGGGGGGGGMGGGGGGGG
GGGGGGGGGGGGGGGGGGGGGGGGGBGGGGGGGGGGGMGGGGMGGGGGGGGGGGGGMGGGGGMGGGGGGGGGGGGBGGGMGGGGGGGGGGGGGGGGGGGG
GGGGGMGGGGMGGGGGGGGGGGGGGBGGGGGGGMGGGGMGGGGGGGGGGGGGGGGGGGGGGGGGGGGGGGGGGGGBGGGGGGGMGGGGGGGGGGGGGGGG
GGGMGGGGGGGGGGGGMGGGGGGGGBGGGGGGGGGGGGGMGGGMGGGGGGMGGGGGGGGGGGGGGGGGGGGGGGGBGGGGGGGGGGGGGGGGGGGGGGGG
GGGGGGGGGGGGGGMGGGMGGGGGGBGGGGGMGGGGGGGGGGGGGGGGGGGGGGGMGGGGGGGGGGGGGMGGGGGBGGGGGGGGGGGGGGGGGGGGGGGG
GGGGGGGGGGGGGGGGGGGGGGGGGBGGGGGGGGGGGGGGGGGGGGGGMGGGGGGGGGGGGGGGGGGGGGGGGGGBGGGGGGGGGGGGGGGGGGGGGGGG
GGGGGGGGGGGGGGGGGGGGGMGGGBGGGGGGGGMGGGGMGGGGGGMMGGGGGGGMGGGGMGGGGGGMGGGGGGGBGGGGGGGGGGGGGGGGGGGGGGGG
GGGGGGGGGGGGGGGGGGGGGGGGGBGGGGGGGGGGGGGGGGGGGGGGGGGGGGGMMMGGGGGGGGGGGGGGGGGBGGGGGMGGGGGGGGGGGGMGGGMG
GMGMGGGGGGGGGGGGGMGGGGGGGBGGGGGGGGGGMMGGGGGGGGGGGGGGMMMGGGGGGGGGGGGGGGGGGGGBGGGGGGGGGGGGGGGGGGGGGGGG
BBBBBBBBBBBBBBBBBBBBBBBBBBBBBBBBBBBBBBBBBBBBBBBBBBBBBBBBBBBBBBBBBBBBBBBBBBBBBBBBBBBBBBBBBBBBBBBBBBBB
GGGGGGGGGGGGGGGGGGGGGGGGMBGGGGGGGGGGGGGGGGGGMGGGGGGMGGGGGGGGGGGGGGGGGGGGGGGBGGGGGGGGGGGGGGGGGGGGGGGG
GGGGGGGGGMGGGGGGGGGGGGGGGBGGGMGGGGGMGGGGGGGGGGGGGGGGGGGGGMGGGGGGGGGGGGGGGGGBGGMGGGGGGGGMGGMGGGGGGGGG
GMGGGGGGGGGGGGGGGGGGGGGGGBGGGGGGGGGGGGGGGGGGMGGGGGGGGGGGGGGGGGGGGGGGGGGGGGGBGGGGGGGGGGGGGGGGGGGGGMGG
GGGMGGGGGGGGGGGGGGGGGGGGGBGGGGGGGGGGGGGGGGGGGGGGGGGGGGGGGGGGGGGGGGGGGGGGGGGBMGMGGMGMGGGGGGGGGGGGGGGG
GGGGGGGGGMGMGGGGGGGMGGGGGBGGGGGMGGGGGGGGGGGGGGGGGGGGGGMGGGMGGMGGGGGGGGGGGGGBGGGGGGGGGGGGGGGGGGGGGGGG
GGGGGGGGGGGGMGGGGGGGGGGGGBGGGGGGGGGMGGGGGGGGGGMGGGGGGGGGGGGGGGGGGGGGGMGGGGGBGGGGGGGGGGGGGGGGGGGGGGGG
GGGGGGGGGGMGGGGGGGGGGGGGGBGGGGGGGGGGGGGGGGGGGGGGGGGGGGGGGGGGGGGGGGGGGGGGGGGBGGGGGGGGGGGGGGGGGGGGGGGG
GGGGGGGGGGGGGGGGGGGGGGGGGBGGGGGGGGGGGGGGGGGGGGGGGMGGGGGGGGGGGGGGGGGGGGGGGGGBGGGGGMGGGGGGGGGGGGGGGGGG
GGGMGGGGGMGGGGGGGGGGGGGGGBGGGGGGGGGGGGGGGGGGGGGGGGGGGGGGGGGGGGGGGGGGGGGGGGGBGGGGGGGGGGGGGGGGGGGGGGGG
GGGGGGGGMGGGGGGGGGGGGGGGGBGGGGGGGGGGGGGGGGGGGGGGGGGGGGGGGGGGGGGGGGGGGGGGGGGBGGGGGGGGGGGGGGGGGGGGGGGG
GGGGGGGGMGGGGGGGGGGGGGGGGBGGGGGGGGGGGGGGMGGGGGGGGGGGMGGGGGGGGGGMGGGGGGGGGGGBGGGMGGGGGGGGGGGGGGGGGGGM
GGGGMGMGGGGGGGGGGGGGGGGGGBMGGGGGGGGGGGGGGGGGGGGGGGGGGGGGGGGGGGGGGGGGGGGGGGGBGMGGGGMGGGGGGMGGGGGGGGGG
GGGGGGGGGGMGGGGGGGGGGGGGGBGGGGGGGGGGGGGGGGGGGGGGGGGGGGGGGGGGGGGGGGGGGGGGGGGBGGGGGGGGGGGGGGGGMGGGGGGG
GGGGGMGGGGGGGGGGGGGGGGGGGBGGGGGGGMGGGGGGGGGGGGGGGGGGGGGGGGGGGGGMGGGGGGGGGGGBGGGGGGGGGGGGGGGGGGGGGGGG
GGGGMGGGGGGGGGGMGGGGGGGGGBGGGGGGGGGGGGGGGGGGGGGGGGGMGGGGGGGGGGGGGGMGGGGGGGGBGGGGGGGGGGGGGGGGGGGGGGGG
GGGGGGMGGGGGGGGGGGGGGGGGGBGGGGGGGGGGGGMGMGGGGGGGGGGGGGGGGGGGGGMGGGGGGGGGGGGBGGGGGGGGMMGGGGGGGGMGGMMG
GGGGGGGGGGGGGGGGGGGGGGGGGBGGGGGGGGGGGGGGGGGGMGGGGGGGGGMGGGGGGMGGGGGGGGGGGGGBGGGGGGGGGGGGGGGGGGGGGGGG
GGGGMGGGGGGGGGGGGGGGGGGGGBGGGMGGGGGGGGGGGGGGGGGGGGGGGGGGGGGGMGGGGGGGGGGGGGGBGGGGGGGGMGGGGGGGGGGGGGGG
GGGGGGGGGGGGGGGGGGGGGGGGGBGMGGGGGGGMGGGGGGGGGGGGGGGGGGGGGGGGGGGGGGGGGGGGGGGBGMGGGGGGGGMGGGGGGGGGGGGG
GGGMGGGGGGGGGGGGGGGGGGGGGBGGGGGGGGGGGGGGGGGGGGGGGMGGGGGGGGGGGGGGGGGGGMGGGGGBGGGGGGGGGGGGGGMGGGGGGGGG
GGGGGGGGGGGGGGGMGGGGGMGGGBGGGGGGMGGGMGGGGGGGGGGGMGGGGGGGGGGGGGGGGGGGGGGGMGGBGGGGGGGGGGGGGGGGGGGGGGGG
GGGGGGGGGGGGGGGGGGGMGGGGGBGGGGGGGGGGGGGGGGGGGGGGGGGGGGMGGGGGGGGGGGGGGGGGGGGBGGGGGGGGGGGMGGGGGGGGGGGG
GGGGGGGGGGGGGGGGGGGGGGGGGBGGGGMGGGGGGGGGGGGGGGGGGGMGGGGGGGGGGGGGGGGGGGGGGGGBGGGGGGGGGGGGGGGGGGGGGGGG
GGGGGGGGMGGGGGGGGGGGGGGGGBGGGGGGGGGGGGGGGGGGGGGGGGGGGGGGGGGGGMGGGGGGGGGGGGGBMGGGGGGGGGGGGGGMGGGGGGGG
